SOXOOOOXXOXOX
OOODXOOOOODOX
XOXOOOOXXOXOX
OODXODXOODOOO
XXOOXOOOXXXXO
ODOXOXOOXXOOO
XODXOXXDOODXD
OXOODOOOXOOOO
OODOOXXOXXXXO
XXOOOOXOOOOOD
XXOXXOODXXXOG